BatchNum	3
PatchModel	0
Resolution	100
LandType	9
MaxHabitats	1
SpeciesDist	0
DistResolution	100
Reproduction	1
RepSeasons	1
StageStruct	0
Stages	1
Transfer	0
ParameterFile	paramFileRScue.tsv
LandFile	landFileRScue.tsv
StageStructFile	NULL
EmigrationFile	emigFileRScue.tsv
TransferFile	transFileRScue.tsv
SettlementFile	settFileRScue.tsv
GeneticsFile	geneticsFileRScue.tsv
TraitsFile	traitsFileRScue.tsv
InitialisationFile	initFileRScue.tsv
